
NO minecraft4.xpm
SO minecraft3.xpm
WE minecraft2.xpm
EA minecraft1.xpm
F 122,122,122
 C 200,200,200

11111111111111111111111111111111
11111111111110000000000000000001
11110000000000000000000000001111
11111111111100000000000000000001
11111111111100000000000000N00001
11111111111100000000000000000001
11111111111111111111111111111111
