NO ./minecraft1.xpm
SO ./minecraft2.xpm
WE ./minecraft3.xpm
EA ./minecraft4.xpm

F 164,169,20
C 153,204,255

111111111111
1         11
1      1   1
111111101111
10S000000001
111111111111
11         1
111111111111
